#######################################
# Syntax Coloring Map LibrairiesAsynchrones
#######################################

#######################################
# Datatypes (KEYWORD1)
#######################################
RcSeq	KEYWORD1
SoftRcPulseIn	KEYWORD1
SoftRcPulseOut	KEYWORD1
RcTxSerial	KEYWORD1
RcRxSerial	KEYWORD1
SoftSerial	KEYWORD1
TinyOscCal	KEYWORD1
TinySoftPwm	KEYWORD1
TinyPinChange	KEYWORD1
RcPpmFrame	KEYWORD1
TinyPpmGen	KEYWORD1
TinyPpmReader	KEYWORD1
RcRxPop	KEYWORD1
RcTxPop	KEYWORD1
Rcul	KEYWORD1
SBusRx	KEYWORD1
SBusTx	KEYWORD1
#######################################
# Methods and Functions (KEYWORD2)
#######################################
TinyPinChange_Init	KEYWORD2
TinyPinChange_RegisterIsr	KEYWORD2
TinyPinChange_EnregistreFonctionInterruption	KEYWORD2
TinyPinChange_EnablePin	KEYWORD2
TinyPinChange_ActiveBroche	KEYWORD2
TinyPinChange_DisablePin	KEYWORD2
TinyPinChange_DesactiveBroche	KEYWORD2
TinyPinChange_GetPortEvent	KEYWORD2
TinyPinChange_RetourneEvenemenPort	KEYWORD2
TinyPinChange_GetCurPortSt	KEYWORD2
TinyPinChange_RetourneEtatCourantPort	KEYWORD2
TinyPinChange_PinToMsk	KEYWORD2
TinyPinChange_MasqueDeBroche	KEYWORD2
TinyPinChange_Edge	KEYWORD2
TinyPinChange_Front	KEYWORD2
TinyPinChange_RisingEdge	KEYWORD2
TinyPinChange_FrontMontant	KEYWORD2
TinyPinChange_FallingEdge	KEYWORD2
TinyPinChange_FrontDescendant	KEYWORD2
RcPpmFrame_Init	KEYWORD2
RcPpmFrame_SetPolar	KEYWORD2
RcPpmFrame_SetChannelPulseWidth	KEYWORD2
RcPpmFrame_Generate	KEYWORD2
RcSeq_Init	KEYWORD2
RcSeq_DeclareSignal	KEYWORD2
RcSeq_SignalTimeout	KEYWORD2
RcSeq_DeclareKeyboard	KEYWORD2
RcSeq_DeclareClavier	KEYWORD2
RcSeq_DeclareStick	KEYWORD2
RcSeq_DeclareManche	KEYWORD2
RcSeq_DeclareServo	KEYWORD2
RcSeq_ServoWrite	KEYWORD2
RcSeq_DeclareCustomKeyboard	KEYWORD2
RcSeq_DeclareClavierMaison	KEYWORD2
RcSeq_DeclareMultiPosSwitch	KEYWORD2
RcSeq_DeclareInterMultiPos	KEYWORD2
RcSeq_DeclareCommandAndSequence	KEYWORD2
RcSeq_DeclareCommandeEtSequence	KEYWORD2
RcSeq_DeclareCommandAndShortAction	KEYWORD2
RcSeq_DeclareCommandeEtActionCourte	KEYWORD2
RcSeq_LaunchSequence	KEYWORD2
RcSeq_LanceSequence	KEYWORD2
RcSeq_LaunchShortAction		KEYWORD2
RcSeq_LanceActionCourte		KEYWORD2
RcSeq_Refresh	KEYWORD2
RcSeq_Rafraichit	KEYWORD2
RcSeq_IsSequenceInProgress	KEYWORD2
RcSeq_SequenceEstEnCours	KEYWORD2
setPwmMin	KEYWORD2
setPwmMax	KEYWORD2
getPwmMin	KEYWORD2
getPwmMax	KEYWORD2
write	KEYWORD2
init	KEYWORD2
setMode	KEYWORD2
getMode	KEYWORD2
saveSetupInEeprom	KEYWORD2
getEepromStorageSize	KEYWORD2
refresh	KEYWORD2
LibVersion	KEYWORD2
LibRevision	KEYWORD2
LibTextVersionRevision	KEYWORD2
attach	KEYWORD2
attache	KEYWORD2
available	KEYWORD2
disponible	KEYWORD2
width_us	KEYWORD2
largeur_us	KEYWORD2
detach	KEYWORD2
write	KEYWORD2
write_us	KEYWORD2
read	KEYWORD2
lit	KEYWORD2
read_us	KEYWORD2
lit_us	KEYWORD2
attached	KEYWORD2
estAttache	KEYWORD2
setMinimumPulse	KEYWORD2
definitImpulsionMinimum	KEYWORD2
setMaximumPulse	KEYWORD2
definitImpulsionMaximum	KEYWORD2
refresh	KEYWORD2
rafraichit	KEYWORD2
createInstance	KEYWORD2
createdInstanceNb	KEYWORD2
softRcPulseOutById	KEYWORD2
getIdByPin	KEYWORD2
destroyInstance	KEYWORD2
begin	KEYWORD2
end	KEYWORD2
read	KEYWORD2
available	KEYWORD2
isListening	KEYWORD2
overflow	KEYWORD2
flush	KEYWORD2
listen	KEYWORD2
txMode	KEYWORD2
rxMode	KEYWORD2
begin	KEYWORD2
setChWidth_us	KEYWORD2
isSynchro	KEYWORD2
suspend	KEYWORD2
resume	KEYWORD2
attach	KEYWORD2
detectedChannelNb	KEYWORD2
width_us	KEYWORD2
ppmPeriod_us	KEYWORD2
isSynchro	KEYWORD2
suspend	KEYWORD2
resume	KEYWORD2
RcRxPopIsSynchro	KEYWORD2
RcRxPopGetWidth_us	KEYWORD2
available	KEYWORD2
read	KEYWORD2
msgAvailable	KEYWORD2
lastWidth_us	KEYWORD2
nibbleAvailable	KEYWORD2
reassignRcRxPopSrc	KEYWORD2
RcTxPopIsSynchro	KEYWORD2
RcTxPopSetWidth_us	KEYWORD2
process	KEYWORD2
RculIsSynchro	KEYWORD2
RculGetWidth_us	KEYWORD2
RculSetWidth_us	KEYWORD2
serialAttach	KEYWORD2
process	KEYWORD2
isSynchro	KEYWORD2
rawData	KEYWORD2
width_us	KEYWORD2
flags	KEYWORD2
sendChannels	KEYWORD2

#######################################
# Constants (LITERAL1)
#######################################
SOFT_RC_PULSE_IN_VERSION	LITERAL1
SOFT_RC_PULSE_IN_REVISION	LITERAL1
SequenceSt_t	LITERAL1
KeyMap_t	LITERAL1
SHORT_ACTION_TO_PERFORM	LITERAL1
ACTION_COURTE_A_EFFECTUER	LITERAL1
MOTION_WITH_SOFT_START_AND_STOP	LITERAL1
MOTION_WITHOUT_SOFT_START_AND_STOP	LITERAL1
MVT_AVEC_DEBUT_ET_FIN_MVT_LENTS	LITERAL1
MVT_SANS_DEBUT_ET_FIN_MVT_LENTS	LITERAL1
RC_CUSTOM_KEYBOARD	LITERAL1
RC_CLAVIER_MAISON	LITERAL1
RC_SEQUENCE	LITERAL1
CENTER_VALUE_US	LITERAL1
VALEUR_CENTRALE_US	LITERAL1
RC_SEQ_START_CONDITION	LITERAL1
RC_SEQ_CONDITION_DE_DEPART	LITERAL1
RC_SEQ_END_OF_SEQ	LITERAL1
RC_SEQ_FIN_DE_SEQ	LITERAL1
TINY_PPM_GEN_POS_MOD	LITERAL1
TINY_PPM_GEN_NEG_MOD	LITERAL1
